##########
#S   #  E#
#    #   #
#        #
##########